NO ./texture/redbrick.xpm
SO ./texture/bluestone.xpm
WE ./texture/greystone.xpm
EA ./texture/purplestone.xpm
F 220,100,0
C 225,30,0

    11111111111111111111111
  11110000000000000000000011
 1101110000111111110111100011
 10000000010000000001000000011
 10000000010000000001000000011
 10000000010000000001000000011
 10000000011111111111000000011
 100000000000E0010100000011101
 10110001111001110001111000111
 10000000000000000000000010001
 1000eeeeeeeeeeeeeeeeeee0000011
11000000000000000000000000000011
10000eeeeeeeeeeeeeeeeeee00000001
10000000000000000000000000000001
11000eeeeeeeeeeeeeeeeeee00000011
 100000000000000000000000000011
 10000000111111111110000000001
 10000000100000000010000000001
 11000000111111111110000000001
 10000000000000000000000000001
 10000000000000000000000000001
 10000000000000000000000000001
 11111111111111111111111111111