NO ./texture/redbrick.xpm
SO ./texture/bluestone.xpm
WE ./texture/greystone.xpm
EA ./texture/purplestone.xpm
F 220,100,0
C 225,30,0

1111    11111111111 1111111111111
1111    1000000001111000000000011
1111    1011000001110000000000011
        1001000000000000000000001
1111111110110000011100000000000001
10000000001111100111011111eW111111
1111011111111 1111000000100001
111101111111111111010100000001
11000000110101011100000000011
1100000000000000110000000001 
11000000000000001101010000011
1100000111010101111101110000111
11110111 1110101 101111010011
11111111 1111111 11111111111
