NO ./texture/redbrick.xpm
SO ./texture/bluestone.xpm
WE ./texture/greystone.xpm
EA ./texture/purplestone.xpm
F 220,100,0
C 225,30,0

1111    11111111111 1111111111111
1111    100000000111100000S000011
1111    1011000001110000000000011
        1001000000000000000000001
1111111110110000011100000000000001
10000000001111100111011111e011111
1111011111111 111100000010e0011111
11110111111111111101010000e001
11000000110101011100000000e11
110000000000000011000000eee1 
11000000000000001101010000e11
11000001110101011111011100e0111
11110111 1110101 101111010e11
11111111 1111111 11111111111
