NO ./texture/redbrick.xpm
SO ./texture/bluestone.xpm
WE ./texture/greystone.xpm
EA ./texture/purplestone.xpm
F 220,100,0
C 225,30,0

1111    11111111111 1111111111111
1111    1000000001111000000000011
1111    1011000001110000000000011
        1001000000000000000000001
11111111101100000111000000e000001
10000000001111100111011111e111111
1111011111111 111100000010e01
11110111111111111101010000e01
11000000110101011100000000e11
11000000000000001100000000e1 
11000000000000001101010000011
1100000111010101111101110000111
11110111 1110101 101111010N11
11111111 1111111 11111111111
