NO ./texture/redbrick.xpm
SO ./texture/bluestone.xpm
WE ./texture/greystone.xpm
EA ./texture/purplestone.xpm
F 220,100,0
C 225,30,0

1111    11111111111 1111111111111
1111    1000000001111000000000011
1111    1011000001110000000000011
        100100000000000000e000001
111111111011000001110000000000001
100000000011111001110111110111111
1111011111111 111100000010001
11110111111111111101010010001
11000000110101011100000010011
1100000000000000110000001001 
11000000000000001101010010011
1100000111010101111101111000111
11110111 1110101 101111010N11
11111111 1111111 11111111111
