NO ./texture/colorstone.xpm
SO ./texture/colorstone.xpm
WE ./texture/colorstone.xpm
EA ./texture/colorstone.xpm
F 220,100,0
C 225,30,0

1111111111111111111111111111
1000000000000000000000000001
1000000000000000000000000001
1000000000000000000000000001
1000000000000000000000000001
1000001000000000000000000001
1000001000000W00000000000001
1000001000000000000000000001
1000000000000000000000000001
1000000000000000000000000001
1111111111111111111111111111