NO ./textures/redbrick.xpm
SO ./textures/wood.xpm
WE ./textures/greystone.xpm
EA ./textures/bluestone.xpm


C 200,200,50
F 200,100,20

     111111111111111111111
   1110000000000000000000011
  101110000111111110111100011
 10000000010000000001000000011
 10000000010000000001000000011
 10000000010000000001000000011
 10000000011111111111000000011
 100000000000E0010100000011101       1
 10110001111001110001111000111      101
 10000000000000000000000010001       1
 10000000000000000000000000001
 100000000000000000000000000001
10000000000000000000000000000001
10000000000000000000000000000001
 100000000000000000000000000001
 10000000000000000000000000001
 10000000111111111110000000001
 10000000100000000010000000001
 11000000111111111110000000001
 10000000000000000000000000001
 10000000000000000000000000001
 10000000000000000000000000001
 11111111111111111111111111111