NO./texture/colorstone.xpm
SO./texture/colorstone.xpm
WE./texture/colorstone.xpm
EA./texture/colorstone.xpm
F 220,100,0
C 225,30,0



1111    11111111111 1111111111111
1111    1000000001111000000000011
1111    1011000001110000000000011
        1001000000000000000000001
111111111011000001110000000000001
100000000011111001110111111111111
1111011111111 111100000010001
11110111111111111101010010001
11000000110101011100000010011
1100000000000000110000001001 
110000000000000011010100100111
11000001110101011111011110N0111
11110111 1110101 101111010011
11111111 1111111 11111111111 

