NO ./texture/colorstone.xpm
SO ./texture/colorstone.xpm
WE ./texture/colorstone.xpm
EA ./texture/colorstone.xpm


C 100,200,255
F 220,100,0




     11111111111
     1  10111111
  11    111    1
1111111110111111
1000000100000001
1000000100000001
1100110000111011
1000000100000001
10000001000N0001
1111111111111111